山山山山山山山山山山山山山山山山山山山山山山山山山木木木木木木木木木木木木木木木
田田田田田山山山山山山山山山山木木木木木木木木木木木木木木木木木木木木木木木木木
水水水水水山山山山山木木木木木木木木木木木木木木木木木木木木木木木木木木木木木木
木木木木木山山山山山山山山山山木木木木木木木木木木木木木木木木木木木木木木木木木
市市市市市山山山山山山山山山山山山山山山木木木木木木木木木木木木木木木木木木木木
山山山山山山山山山山山山山山山木木木木木木木木木木木木木木木木木木木木木木木木木
田田田田田山山山山山山山山山山山山山山山木木木木木木木木木木木木木木木木木木木木
水水水水水山山山山山山山山山山木木木木木木木木木木木木木木木木木木木木木木木木木
木木木木木木木木木木木木木木木木木木木木木木木木木木木木木木木木木木木木木木木木
市市市市市木木木木木木木木木木木木木木木木木木木木木木木木木木木木木木木木木木木
山山山山山山山山山山山山山山山山山山山山山山山山山木木木木木木木木木木木木木木木
山山山山山山山山山山山山山山山山山山山山山山山山山木木木木木木木木木木木木木木木
山山山山山山山山山山山山山山山山山山山山山山山山山木木木木木木木木木木木木木木木
山山山山山山山山山山山山山山山山山山山山山山山山山木木木木木木木木木木木木木木木
山水水水水水山水水水水水山水水水水水山山山山山山山山山山山山山山山山山山山山山山
山山山山山山山山山山山山山山山山山山山山山山山山山木木木木木木木木木木木木木木木
山山山山山山山山山山山山山山山山山山山水水水水水山山山山山山山木木木木木木木木木
山山山山山山山山山山山山山山山山山山山山山山山山山木木木木木木木木木木木木木木木
山山山山山山山山山山山山山山山山山山山山山山山山山水水水水水山水水水水水山木木木
山山山山山山山山山山山山山山山山山山山山山山山山山水水水水水山水水水水水山木木木
山山山山山山山山山山山山山山山山山山山山山山山山山水水水水水山水水水水水山木木木
山山山山山山山山山山山山山山山山山山山山山山山山山水水水水水山水水水水水山木木木
山山山山山山山山山山山山山山山山山山山山山山山山山水水水水水山水水水水水山木木木
山山山山山山山山山山山山山山山山山山山山山山山山山木木木木木木木木木木木木木木木
山山山山山山山山山山山山山山山山山山山山山山山山山木木木木木木木木木木木木木木木
山山山山山山山山山山山山山山山山山山山山山山山山山木木木木木木木木木木木木木木木
山山山山山山山山山山山山山山山山山山山山山山山山山木木木木木木木木木木木木木木木
山山山山山山山山山山山山山山山山山山山山山山山山山木木木木木木木木木木木木木木木
山山山山山山山山山山山山山山山山山山山山山山山山山木木木木木木木木木木木木木木木
山山山山山山山山山山山山山山山山山山山山山山山山山木木木木木木木木木木木木木木木
山山山山山山山山山山山山山山山山山山山山山山山山山木木木木木木木木木木木木木木木
山山山山山山山山山山山山山山山山山山山山山山山山山木木木木木木木木木木木木木木木
山山山山山山山山山山山山山山山山山山山山山山山山山木木木木木木木木木木木木木木木
山山山山山山山山山山山山山山山山山山山山山山山山山木木木木木木木木木木木木木木木